1555555551
1000000001
1022002201
1022002201
1000000001
1330000331
1000000001
1022002201
1022002201
1000000001
1444444441
